111111
100101
100001  01
1100N1  
111111