NO ./textures/bus.png
SO ./textures/bus.png
WE ./textures/bus.png
EA ./textures/bus.png

C  0,0,255
F  255,0,0

1111111
1000001
1111111
       
1111111
100E001
1000001
1111111
