NO      ./textures/eagle.png
SO         ./textures/bus.png
WE ./textures/bus.png
EA ./textures/bus.png

F 220,100,80
C 225,30,90

1111111
1001001
100E001
1100001
1111111