111111
100101   111
10100001   101
1100N1   111
111111