NO ./textures/north2.xpm
SO ./textures/south.xpm
WE ./textures/west.xpm
EA ./textures/east.xpm

C 225,30,0
F 166,40,6

1111111 111
1N00001 101
1111111 111
