111111
100101
100E01
110E01  
111111