EA           				./textures/wood.png
NO ./textures/bluestone.png
WE ./textures/eagle.png

SO ./textures/colorstone.png

F 0,255,0
C 255,0,0


1111111
1000001
1000001
1001001
10 N001
1000001
1111111