111111
100101
100001  1
1100N1  
111111