C 255,0,0
WE ./textures/bus.png
NO ./textures/bus.png
SO ./textures/bus.png


F 166,40,255
EA ./textures/bus.png

111111111111111111111111111111
100100010001000100010001000101
100000000000000000000000000001
111111111111111111100111111111
110011001100110011001100110011
111011101110111011101110111011
10000000000000000O000000000001
10000000000000000O000000000001
110011001100110011001100110011
111011101110111011101110111011
110011001100110011001100110011
100100010001000100010001000101
100000000000000000000000000001
110001000100010001000100010001
11111111111111111111111111111
