1111111 111
1000001 101
1000001 111
1001001
100E001
1000001
1111111