1111111
1000001
1000001
1001001
1000001
100N001
1111111