111111111111111111111111111111
100100010001000100010001000101
100000000000000000000000000001
11001001000111110011000000011
110011001100110011001100110011
111011101110111011101110111011
100000000000000000000000000001
10000000000E000000000000000001
110011001100110011001100110011
111011101110111011101110111011
110011001100110011001100110011
100100010001000100010001000101
100000000000000000000000000001
110001000100010001000100010001
11111111111111111111111111111
