NO ./textures/wood.png
SO ./textures/colorstone.png
WE ./textures/mossy.png
EA ./textures/redbrick.png

C 135,206,111
F 58,95,222

1111111
10000S1
1000001
1000001
1111111
