NO ./textures/wood.png
SO ./textures/colorstone.png
WE ./textures/mossy.png
EA ./textures/redbrick.png

C 255,0,0
F 166,40,255

111111111111111111111111111111
100100010001000100010001000101
100000000000000000000000000001
111111111111111111100111111111
110011001100110011001100110011
111011101110111011101110111011
10000000000000000E000000000001
100000000000000000000000000001
110011001100110011001100110011
111011101110111011101110111011
110011001100110011001100110011
100100010001000100010001000101
100000000000000000000000000001
110001000100010001000100010001
111111111111111111111111111111